11111111111111111111111111111111
1E0000000001000000010000000C00P1
11011100000100000011111101111101
1001C000000011000001000001000001
10011100011000000001011111000001
10000000010000001001000100010001
101010010000100111000001000C0001
10101001000010001C00000100010001
10101011000000000000000000000001
10101001001010000000100100010001
10000001001010000000100100000001
10010000001000010000100111110101
1001001001110001011110010C000101
100C0010000001010000000110111101
1P000010000100000000100000000001
11111111111111111111111111111111