111111111111111
100000010000001
1000000C0000001
1000000C0000001
1000000C0000001
10P0000E00P0001
1000000C0000001
1000000C0000001
1000000C0000001
100000010000001
111111111111111