111111111111111111111111111111
1000000000000000000000000000P1
101111001101111100111111011001
1010C0000100010C00000111010001
10101111000100011111010C010101
100000000100010000011101100101
101011110101111111010001001101
101010000100001100010001011001
1010C010111110E001110001001101
100011001111111110C00111100001
101110011000011100001111100001
101000000000010000111100000101
101011111000000111111001111001
1P0000000000000000000000000001
111111111111111111111111111111