1111111111111111
1P00000000000001
1000100000010001
100C10010001C001
1011111011111101
1000100100010001
1000100000010001
1000000000000001
10000000E0000001
1000100000010001
1000100000010001
1011111001111101
100C10000001C001
1000100000010001
10000000000000P1
1111111111111111