1111111111111111
100P0000100000E1
1000000010000101
1000000010000001
1000000000000001
10000000C0000001
1000000000000001
1000110000000001
1000111000000001
1010011100000001
101000000P000001
1010000000000001
1010000000000001
1010000000000001
1010000000000001
1111111111111111